1 13 3 3 7 5 5 5 2
E E E E E E E E E E E E E
E E E E E E E E E E E E E
E E E E E E E E E E E E E
E E E E E E E E E E E E E
E E E E E E B E E E E E E
E E E E E E B E E E E E E
E E E E B B B B B E E E E
E E E E E E B E E E E E E
E E E E E E B E E E E E E
E E E E E E E E E E E E E
E E E E E E E E E E E E E
E E E E E E E E E E E E E
E E E E E E E E E E E E E
