2 13 1 1 7 5 5 5 4
E E E E E E E E E E E E E
E E E E E E E E E E E E E
E E E E E E E E E E E E E
E E E B E E B B B E E E E
E E E B E E B E E E B E E
E E E B E E B E E E B E E
E E E B B B B B B B B E E
E E E E E E B E E E E E E
E E E E E E B E E E E E E
E E E E B B B E E E E E E
E E E E E E E E E E B E E
E E E E E E E E E E B E E
E E E E E E E E E E E E E
